30 30
______________________*___*___
________________*_____*___*___
________________*******___*___
________________*_____*_______
_______________*_____*________
________________*_____________
___*__________________________
___*__________________________
___*__________________________
___*____*________****_________
___*____*_____________________
___*____*_____________________
___*____*______***************
___*____*_____________________
___****************___________
________*****_________________
________*_____________________
________*_____*_______________
**______*______*******________
________*_____*_______________
_______________*______________
______________*_______________
_***********___*______________
****__________*_______________
_______________*______________
*************__*_*____________
_________________*_***********
***______________*____________
_________________*____________
_________________*____________
