160 60
**_____________________________________________________________________________***_____________________________________________________________________________*
*_______________________________________________________________________________**_____________________________________________________________________________*
________________________________________________________________________________**_____________________________________________________________________________*
________________________________________________________________________________**_____________________________________________________________________________*
________*****___________________________________________________________________**_____________________________________________________________________________*
_______*******__________________________________________________________________**_____________________________________________________________________________*
_______*******__________________________________________________________________**_____________________________________________________________________________*
_______*******__________________________________________________________________**_____________________________________________________________________________*
_______*******___________*****________________________*****_____________________**_____________________________________________________________________________*
_______*******__________*******______________________*******____________________**_____________________________________________________________________________*
________*****___________*******__________*****_______*******____________________**_____________________________________________________________________________*
________________________*******_________*******______*******____________________**_____________________________________________________________________________*
________________________*******_________*******______*******____________________**_____________________________________________________________________________*
________________________*******_________*******______*******____________________**_____________________________________________________________________________*
_________________________*****__________*******_______*****_____________________**_____________________________________________________________________________*
________________________________________*******_________________________________**_____________________________________________________________________________*
_______________*****_____________________*****__________________________________**_____________________________________________________________________________*
______________*******____________________________________*****__________________**_____________________________________________________________________________*
______________*******_________*****_____________________*******_________________**_____________________________________________________________________________*
______________*******________*******____________________*******_________________**_____________________________________________________________________________*
______________*******________*******____________________*******_________________**_____________________________________________________________________________*
______________*******________*******_________*****______*******_________________**_____________________________________________________________________________*
_______________*****_________*******________*******_____*******_________________**_____________________________________________________________________________*
_____________________________*******________*******______*****__________________**_____________________________________________________________________________*
_______*****_________*****____*****_________*******_____________________________**_____________________________________________________________________________*
______*******_______*******_________________*******_____________________________**_____________________________________________________________________________*
______*******_______*******_________________*******_____________________________**_____________________________________________________________________________*
______*******_______*******__________________*****______________________________**_____________________________________________________________________________*
______*******_______*******_____________________________________________________**_____________________________________________________________________________*
______*******_______*******_____________________________________________________**_____________________________________________________________________________*
_______*****_________*****______*****________________________*****______________**_____________________________________________________________________________*
_______________________________*******______________________*******_____________**_____________________________________________________________________________*
_______________________________*******_______*****__________*******_____________**_____________________________________________________________________________*
__________*****________________*******______*******_________*******_____________**_____________________________________________________________________________*
_________*******_______________*******______*******_________*******_____________**_____________________________________________________________________________*
_________*******_____*****_____*******______*******_________*******_____________**_____________________________________________________________________________*
_________*******____*******_____*****_______*******__________*****______________**_____________________________________________________________________________*
_________*******____*******_________________*******_____________________________**_____________________________________________________________________________*
_________*******____*******__________________*****______________________________**_____________________________________________________________________________*
__________*****_____*******_____________________________*****___________________**_____________________________________________________________________________*
____________________*******________*****_______________*******__________________**_____________________________________________________________________________*
_____________________*****________*******______________*******__________________**_____________________________________________________________________________*
__________________________________*******______________*******__________________**_____________________________________________________________________________*
_____________*****________________*******_____*****____*******__________________**_____________________________________________________________________________*
____________*******_______________*******____*******___*******____*****_________**_____________________________________________________________________________*
____________*******______*****____*******____*******____*****____*******________**_____________________________________________________________________________*
____________*******_____*******____*****_____*******_____________*******________**_____________________________________________________________________________*
____________*******_____*******______________*******_____________*******________**_____________________________________________________________________________*
____________*******_____*******______________*******_____________*******________**_____________________________________________________________________________*
_____________*****______*******_______________*****______________*******________**_____________________________________________________________________________*
________________________*******__________________________*****____*****_________**_____________________________________________________________________________*
_________________________*****______*****_______________*******_________________**_____________________________________________________________________________*
_______________*****_______________*******______________*******_________________**_____________________________________________________________________________*
______________*******______________*******______________*******_________________**_____________________________________________________________________________*
______________*******______________*******______________*******_________________**_____________________________________________________________________________*
______________*******______________*******______________*******_________________**_____________________________________________________________________________*
______________*******______________*******_______________*****__________________**_____________________________________________________________________________*
______________*******_______________*****_______________________________________**_____________________________________________________________________________*
*______________*****____________________________________________________________**_____________________________________________________________________________*
**_____________________________________________________________________________***_____________________________________________________________________________*
